     _                    _   _    _       _ 
    | |                  | | | |  | |     | |
    | |     _____   _____| | | |  | |_ __ | |
    | |    / _ \ \ / / _ \ | | |  | | '_ \| |
    | |___|  __/\ V /  __/ | | |__| | |_) |_|
    |______\___| \_/ \___|_|  \____/| .__/(_)
                                    | |      
                                    |_|      